28
11
0000000000000000000000000000
0000000000000000000000500000
0000000000000000000000200000
0000000000000050050100004444
0000500004444222024433331111
0002220001111000001133331111
6000000041111300001133331111
4400000011111130001113311111
1100000011111130001111311111
1133333311111113301111111111
1111111111111111131111111111
