80
32
00000000000000000000000000000000000000000000000000000000000000000000000000000000
00000000000000000000000000000000000000000000000000000000000000000000000000000000
00044444444444444444444444444444444000000000000000000000000000000000000000000000
00040000000000000000000000000000004444444444444444444444444444444444444444440000
00040000000000000000000000000000000000000000000000000000000000000000000000044000
00040000500000000000000000000000000000000000000000000000000000000000000000004000
00040000000000000000000000000000000000000000000000002000000000000000000000004000
00040500000000444444444444444400000000000000000005005000000000000000000005004000
00040000000000000000000000000400000000000000000000000000000000000000000000004000
00040000500000000000000000000444444444400000444444444444444444400004444444444000
00046000000000000000000000000000000000433333400000000000000000400004000000000000
00044444444444444400005500000025050500444444404444444444444440400004000000000000
00000400000000000000050050000000000000400000004000000400000000400004000000000000
00000400000000000000000000444444444444400444444044440404444444400004444444400000
00000400000000000004444444400000000000000400000000000404000000000000000000400000
00000400000000004444000000444400044444444444444444444404000000000000000000400000
00000400000000444000000000000444000000000000000000000004444444400004444444400000
00000400000004400000000000000004444444444444444444444444000000400004000000000000
00000400000004000000000000000000000000000000000000000000000000400004000000000000
00000444000000000000000000000000000000000000000000000000000000400004000000000000
00000004000000000000000500000000000000000000000000000000000000000004000000000000
00000004000000000000000000000000000000000000000000000005000000000004000000000000
00000004444444440000004440000044444444444400000000000000000000000004400000000000
00000000000004000000000000000000400000000444440000444444405000000000444444440000
00000000000004333333333333333333400000000000040000400000400000000000000000040000
00000000000004333333333333333333400000000004440000444000444405000000000000040000
00000000000004444444444444444444400000000004000000004000000400000000000000040000
00000000000000000000000000000000000000000004333333334000000444400000000000040000
00000000000000000000000000000000000000000004333333334000000000400000000000040000
00000000000000000000000000000000000000000004333333334000000000444444444444440000
00000000000000000000000000000000000000000004444444444000000000000000000000000000
00000000000000000000000000000000000000000000000000000000000000000000000000000000