80
11
00000000000000000000000050000000000000000050000000000000000000000000000000000000
06000000000000000000000000000000000000000222200000000000000000000005000000050000
44400000000004444000000050000000000000000000000000000000000000000222220000000444
00400000000004004000000000000000000000000000000000000000000000000000000000000400
00444444444444004444444444444440004444444444444444444400004444444400044444444400
00000000000000000000000000000040004000000000000000000400004000000000000000000000
00000000000000000000000000000043334000000000000000000433334000000000000000000000
00000000000000000000000000000043334000000000000000000433334000000000000000000000
00000000000000000000000000000044444000000000000000000444444000000000000000000000
00000000000000000000000000000000000000000000000000000000000000000000000000000000
00000000000000000000000000000000000000000000000000000000000000000000000000000000